#######
#.    #
#$ ##@#
#.    #
#######