#######
#.###.#
#  @  #
#     #
#   $ #
#.###.#
#######