#######
#.  @ #
#     #
#$ ## #
#.    #
#######
