#######
#.###.#
# $@  #
#     #
#   $ #
#.###.#
#######